00500093
00500113
00208463
06300193
02a00213